adolescence - отрачество
adulthood - совершеннолетие
bond - связь
brotherhood - братство
character - характер
fatherhood - отцовство
interaction - взаимодействие
relation - отношение
resemblense - сходство
rivalry - соперничество
ties - связи
upbringing - воспитание
gathering - сбор
stable - стабильный
striking - поразительный
close - близкий
maternal - материнская
parernal - отцовский
reward - награда
accommodate - приспосабливаться
adopt - принимать
endure - терпеть
establish - устанавливать
interact - взаимодействовие
nurture - воспитывать
concept - концепция
consequence - последствие
gesture - жест
growth - рост
imagination - воображение
infancy - младенчество
maturity - зрелость
milestone - веха
peers - сверстники
rate - скорость
phase - фаза
reminder - напоминание
stage - стадия
toddler - ползунок
transition - переход
abstract - абстрактный
clumsy - неуклюжий
cognitive - познавательный
fond - нежный
fully-grown - взрослый
independent - независимый
patient - терпеливый
rebellious - мятежный
sagnificant - значимый
acquire - приобретать
develop - развивать
imitate - подражать
reminisce - вспоминать
tantrum - раздражение
anxiety - тревожность
allergy - аллергия
asset - вклад
benefit - польза
cravings - склонность
diagnosis - диагноз
dietician - диетолог         
disease - недуг
disorder - расстройство
harm - вред
insomnia - бессонница
intake - потребление
junk - хлам
muscle - мускул
nutrition - питание
obesity - ожирение
onset - начало
serving - порция
stroke - инсульт
treatment - лечение
variety - разнообразие
acure - лекарство
alternate - чередовать
brisk - подвижный
chronic - хронический
moderate - умеренный
persistent - упорный
vital - существенный
avoid - избегать
counteract - противодействовать
curb - обуздать
disturb - беспокоить
maintain - поддерживать
overdo - переусердствовать
prevent - предотвращать
recover - выздоравливать
reduce - сокращать
trigger - инициировать
essential - необходимый
rapid - быстрый
obstacle - препятствие
quite - достаточно
quiet - тихо
alike - похож
assist - помощь
shoelaces - шнурки
unparalleled - бесподобный
gains - доходы
grasp - схваывать
responsible - ответственный
overdue - просроченный
even - даже
memorise - запоминать
memorible - памятный
pump - качать
